11111111
1P0000C1
11110011
1R000001
10110001
101R0001
10011001
1E000101
1000C001
11111111