1111111111111111111111111111111111
10000000000000C00000C0000000000001
1010000R10000000101001000R00010101
10100001100010100010010000R0010101
1P1E00000C00C0000000000000000000C1
1111111111111111111111111111111111