111111
1P00C1
111101
1C0001
101101
101C01
100111
1000E1
111111