1111111111111111111111111111111111
100000000000000C00000C000000000001
10100000E0000000101001000R00010101
1010000000001010001001000000010101
1P1000000C00C0000000000000000000C1
1111111111111111111111111111111111